Богородицкая	Екатерина	Дмитриевна
Воробьев	Дмитрий	Максимович
Воронова	Анастасия	Васильевна
Жулин	Кирилл	Сергеевич
Иванов	Андрей	Романович
Козлова	Оксана	Олеговна
Кокина	Александра	Евгеньевна
Комягин	Александр	Сергеевич
Малышева	Екатерина	Алексеевна
Мусатов	Антон	Владимирович
Овакимян	Кристина	Артуровна
Панкратова	Анжелла	Александровна
Полюхов	Владислав	Вадимович
Пьянзин	Артём	Алексеевич
Рожкова	Полина	Алексеевна
Селивановская	Дарья	Евгеньевна
Страхов	Илья	Александрович
Удачина	Анастасия	Кирилловна
Базаркин	Андрей	Геннадьевич
Батурина	Анна	Андреевна
Волох	Семен	Михайлович
Вохмянина	Александра	Сергеевна
Голубева	Александра	Сергеевна
Дорошенко	Илья	Дмитриевич
Ермолаев	Сергей	Александрович
Замелин	Павел	Алексеевич
Ильин	Артем	Анатольевич
Коркунов	Антон	Сергеевич
Корольков	Андрей	Алексеевич
Мельников	Евгений	Дмитриевич
Мещерин	Антон	Андреевич
Моисеев	Артем	Александрович
Носков	Андрей	Алексеевич
Огурлиев	Анзор	Амербиевич
Орлова	Ольга	Владимировна
Поляков	Валерий	Игоревич
Разживин	Иван	Дмитриевич
Соловьева	Алина	Владимировна
Цыплаков	Павел	Максимович
